...###
..##.#.#.##
.##..###..#
##...#....#
....##.#..#
###..###..#
..#..#....#
.##.##.#.##
#......##
#.....
.###@###