.......###
..##.#...##
##..###..#
##...#....#
....##.#..#
###..###..#
@.#..#....#
..#.##.#.##
#......##
#.....
.######